x..........................x
x..........................x
x..........................x
x..........................x
x..........................x
x..........................x
x..........................x
x..........................x
x.........xx...............x
x.........xx...............x
x.....xx...................x
x.....xx...................x
xxxxxxxxxxxxxxxxxxxxxxxxxxxx
