x..........................x
x..........................x
x..........................x
x..........................x
x..........................x
x..........................x
x..........................x
x..........................x
x..........................x
x..........................x
x..........................x
x..........................x
x..........................x
x..........................x
x..........................x
x..........................x
x..........................x
x..........................x
x..........................x
x................xxxx......x
x..........................x
x............xxx...........x
x........xxx...............x
x........xxx...............x
x.....xx...................x
x.....xx...................x
xxxxxxxxxxxxxxxxxxxxxxxxxxxx
